addictively          : additively          
addictive            : additive            
alkane               : alkene              
automation           : automaton           
beats                : beast               
beating              : bearing             
beat                 : beta                
began                : begun               
bets                 : best                
blend                : blind               
boots                : boost               
bounced              : bounded             
bouncing             : bounding            
braking              : breaking            
bread                : breed               
buys                 : busy                
caching              : catching            
casually             : causally            
casual               : causal              
cats                 : cast                
change               : chance              
charged              : changed             
charging             : changing            
cheat                : chest               
chloride             : chlorite            
clarify              : clarity             
cleared              : cleaned             
clearing             : cleaning            
clearly              : cleanly             
clearer              : cleaner             
clearest             : cleanest            
coats                : coast               
coating              : costing             
competed             : completed           
competing            : completing          
compete              : complete            
compiled             : complied            
complaint            : compliant           
complement           : compliment          
concert              : convert             
contacting           : contracting         
contacted            : contracted          
contact              : contract            
contest              : context             
cooked               : cooled              
cooking              : cooling             
court                : count               
crashed              : crushed             
crashing             : crushing            
crash                : crush               
creed                : cried               
cures                : curse               
dated                : dared               
dating               : daring              
deduced              : deducted            
deducing             : deducting           
defect               : detect              
defective            : detective           
deprived             : derived             
depriving            : deriving            
does                 : dose                
drank                : drunk               
eats                 : east                
excepting            : excerpting          
excepted             : excerpted           
exciting             : exiting             
existing             : exiting             
exits                : exist               
extant               : extent              
facing               : faking              
faced                : faked               
failing              : falling             
fewer                : fever               
fiber                : finer               
field                : filed               
flashed              : flushed             
flashing             : flushing            
flash                : flesh               
forcing              : forking             
forced               : forked              
forged               : forked              
forging              : forking             
forge                : force               
formulate            : formulae            
freed                : fried               
freeing              : freezing            
genetically          : generically         
genetic              : generic             
gentleman            : gentlemen           
grace                : grade               
groan                : grown               
handing              : handling            
hardy                : handy               
heading              : heating             
headed               : heated              
heating              : hearing             
honestly             : honesty             
hurting              : hunting             
identify             : identity            
immoral              : immortal            
impeded              : impended            
impeding             : impending           
inclined             : inlined             
inclining            : inlining            
indent               : intent              
infer                : inter               
inferior             : interior            
inverting            : inventing           
inverted             : invented            
invert               : invent              
layer                : laser               
leaning              : learning            
lets                 : lest                
lighting             : lightning           
lips                 : lisp                
loader               : louder              
lots                 : lost                
lower                : lover               
match                : march               
meat                 : meta                
mono                 : moon                
morality             : mortality           
neatly               : nearly              
nets                 : nest                
newer                : never               
nitride              : nitrite             
normalize            : normalsize          
reorder              : recorder            
overheard            : overhead            
overheating          : overhearing         
overran              : overrun             
overshoot            : overshot            
paging               : paying              
patent               : parent              
phasing              : phrasing            
phosphide            : phosphite           
replaying            : replying            
predicated           : predicted           
predicating          : predicting          
price                : pride               
probe                : prone               
prober               : proper              
promoting            : prompting           
promoted             : prompted            
qualify              : quality             
quantify             : quantity            
quiet                : quite               
rabid                : rapid               
racial               : radial              
radially             : radically           
radio                : ratio               
ranging              : ranking             
ranged               : ranked              
reactor              : refactor            
refusing             : reusing             
reigned              : resigned            
reigning             : resigning           
relying              : replying            
remainder            : reminder            
retired              : retried             
ripping              : rippling            
sentient             : sentiment           
setting              : settling            
shall                : shell               
shift                : shirt               
shooting             : shouting            
shoot                : shout               
shutting             : shuttling           
signing              : singing             
sign                 : sing                
signer               : singer              
singing              : sinking             
slicing              : sliding             
slice                : slide               
small                : smell               
spares               : sparse              
spell                : spill               
spitting             : splitting           
sprang               : sprung              
stack                : stuck               
staff                : stuff               
staged               : stayed              
staging              : staying             
stage                : stake               
staring              : starting            
starting             : stating             
started              : starred             
stated               : stared              
state                : stare               
steal                : steel               
stock                : stuck               
store                : stone               
sulfide              : sulfite             
sweating             : swearing            
sweat                : sweet               
tacking              : tackling            
tear                 : tera                
terse                : tense               
there                : three               
thorough             : through             
throughout           : throughput          
tough                : touch               
traced               : traded              
tracing              : trading             
trace                : trade               
track                : truck               
trail                : trial               
transit              : transmit            
underline            : underlie            
unify                : unity               
warmed               : warned              
warming              : warning             
weakly               : weekly              
weighed              : weighted            
weighing             : weighting           
wets                 : west                
wherever             : whenever            
withdraw             : withdrew            
woman                : women